You wake up in a strange room, not entirely knowing why you are here, or even where you are. There isn't much in the room to suggest why you are here, maybe you can find something in this room to help you remember.

Ragnarok
An Interactive Fiction by Marissa Takebayashi
Release 1 / Serial number 140311 / Inform 7 build 6G60 (I6/v6.32 lib 6/12N) SD

Portal Room
A mostly empty room. The walls are all a bland grey and there are no windows. There is a bookshelf leaning against one of the walls. 

 To the south is the Underworld, Midgard it to the west, and there is a large gate to the north.

A long stone pole. It looks much heavier than it actually is.

 
You can also see a large gate, a statue and Heimdallr here.

>x staff
A long stone staff that the statue is holding.

>take staff
you are going to need to use more force to do that.

>break statue
You reach up and break off the staff that the statue was holding. It is a lot heavier than you expected, but still manageable.

>x staff
A long stone pole. It looks much heavier than it actually is.

* * *

>break statue
You reach up and break off the staff that the statue was holding. It is a lot heavier than you expected, but still manageable.

>s
Underworld
A place that is surprisingly well lit for a place that seems so dark. A chilly wind makes you shiver. You can see the river Gjoll here. 

 To the north is the Portal Room.

You can see Hel's Gate here.

>x gate
While looking at Hel's Gate, you decide that Hel has very interesting decorating tastes. You notice that one of the metal barbs on the gate is loose. You can just reach it. When you hold it, you realize it is a little larger than you expected. It looks like you could combine this with something long to create some sort of fishing pole...

>combine barb with staff
You combine the metal barb and the staff to make a fishing pole. Although you probably won't use it to catch fish. Don't worry, there are other things in the river you can catch besides fish.

>take horn
You stick the fishing pole into the water and skillfully maneuver the metal barb into the horn. With a quick motion, you bring the horn up to the surface and into your pocket.

>n
Portal Room
A mostly empty room. The walls are all a bland grey and there are no windows. There is a bookshelf leaning against one of the walls. 

 To the south is the Underworld, Midgard it to the west, and there is a large gate to the north.

 
You can also see a large gate, a statue and Heimdallr here.

>w
Midgard
You find yourself in a Midgardian janitor's closet. Which is to say, a regular janitor's closet. There are some trash bags and a mop lying next to the door you just came in. 

 To the south is a winding path and to the east is the Portal Room.

You can see a bucket (empty) here.

>take buckt
You can't see any such thing.

>take bucket
Taken.

>e
Portal Room
A mostly empty room. The walls are all a bland grey and there are no windows. There is a bookshelf leaning against one of the walls. 

 To the south is the Underworld, Midgard it to the west, and there is a large gate to the north.

 
You can also see a large gate, a statue and Heimdallr here.

>n
It seems Heimdallr doesn't want you going in there.

>give heimdallr horn
Heimdallr looks pleased. He decides to open the large gate for you.

>n
Valhalla
A good-sized room that looks like it has seen its fair share of parties. It isn't necessarily dirty, but everything is worn. 

 To the west is Asgard's Gate, to the south is the Portal Room.

You can see Asgard's Gate, a large gate and a centerpiece here.

You'll have to get out of Valhalla first.

>open centerpiece
You open the centerpiece, revealing a map.

>take map
Taken.

>s
(first opening the large gate)

Portal Room
A mostly empty room. The walls are all a bland grey and there are no windows. There is a bookshelf leaning against one of the walls. 

 To the south is the Underworld, Midgard it to the west, and there is a large gate to the north.

 
You can also see a large gate, a statue and Heimdallr here.

>w
Midgard
You find yourself in a Midgardian janitor's closet. Which is to say, a regular janitor's closet. There are some trash bags and a mop lying next to the door you just came in. 

 To the south is a winding path and to the east is the Portal Room.

>s
You successfully navigate through the winding path, finding the forest clearing pointed out on the map.

Forest Clearing
A small grassy patch in the middle of the forest. There are tall pine trees surrounding the area. Sunlight filters down into the clearing, but the rest of the forest is obscured. 

 To the north is Midgard.

A large ornate golden key. It looks like it would fit into a large ornate golden gate.

You can also see Mistletoe here.

You'll have to get out of the Forest Clearing first.

>take key
Taken.

>talk to mistletoe
The mistletoe looks unhappy
1) "Why are you unhappy?" 
2) Try to convince the mistletoe not to hurt Baldr 
3) "Is there anything I can do to help?" 
(or 0 to say nothing)
>

>1
"Unhappy? Me? Noo, I'm thinking you are mistaken. Why would I possibly be unhappy? It isn't as if I'm the only living thing deemed too harmless to hurt anyone or anything." 
1) Try to convince the mistletoe not to hurt Baldr 
2) "Is there anything I can do to help?" 
(or 0 to say nothing)
>

>1
"Baldr? I don" have a grudge against anyone named Baldr, but if I see "em, there is nothing stopping me from hurtin" them. That'll show the Gods that I'm not harmless."

1) "Is there anything I can do to help?" 
(or 0 to say nothing)
>

>1
"Well if ya" want to be real nice you could get me somethin" to drink. I'm dyin" out here out in the hot sun and all. Maybe I'll listen to what you have to say after ya" get me some water."

>n
Midgard
You find yourself in a Midgardian janitor's closet. Which is to say, a regular janitor's closet. There are some trash bags and a mop lying next to the door you just came in. 

 To the south is a winding path and to the east is the Portal Room.

>e
Portal Room
A mostly empty room. The walls are all a bland grey and there are no windows. There is a bookshelf leaning against one of the walls. 

 To the south is the Underworld, Midgard it to the west, and there is a large gate to the north.

 
You can also see a large gate, a statue and Heimdallr here.

>n
Valhalla
A good-sized room that looks like it has seen its fair share of parties. It isn't necessarily dirty, but everything is worn. 

 To the west is Asgard's Gate, to the south is the Portal Room.

You can see Asgard's Gate, a large gate and a centerpiece (empty) here.

You'll have to get out of Valhalla first.

>unlock asgards gate
What do you want to unlock Asgard's Gate with?

>key
You unlock Asgard's Gate.

>open gate
Which do you mean, Asgard's Gate or the large gate?

>asgards gate
You open Asgard's Gate.

>w
Asgard
A grand place that is the city of the Gods. Unfortunately you aren't allowed any farther into the city, but from here you can access a large marble fountain, but that is about it. 

 To the west is Valhalla. 

You can see Asgard's Gate and a fountain (in which is fountain water) here.

>fill bucket
What do you want to fill the bucket with?

>water
You fill the bucket with water from the fountain.

>e
Valhalla
A good-sized room that looks like it has seen its fair share of parties. It isn't necessarily dirty, but everything is worn. 

 To the west is Asgard's Gate, to the south is the Portal Room.

You can see Asgard's Gate, a large gate and a centerpiece (empty) here.

You'll have to get out of Valhalla first.

>w
Asgard
A grand place that is the city of the Gods. Unfortunately you aren't allowed any farther into the city, but from here you can access a large marble fountain, but that is about it. 

 To the west is Valhalla. 

You can see Asgard's Gate and a fountain (empty) here.

>e
Valhalla
A good-sized room that looks like it has seen its fair share of parties. It isn't necessarily dirty, but everything is worn. 

 To the west is Asgard's Gate, to the south is the Portal Room.

You can see Asgard's Gate, a large gate and a centerpiece (empty) here.

You'll have to get out of Valhalla first.

>s
Portal Room
A mostly empty room. The walls are all a bland grey and there are no windows. There is a bookshelf leaning against one of the walls. 

 To the south is the Underworld, Midgard it to the west, and there is a large gate to the north.

 
You can also see a large gate, a statue and Heimdallr here.

>w
Midgard
You find yourself in a Midgardian janitor's closet. Which is to say, a regular janitor's closet. There are some trash bags and a mop lying next to the door you just came in. 

 To the south is a winding path and to the east is the Portal Room.

>s
You successfully navigate through the winding path, finding the forest clearing pointed out on the map.

Forest Clearing
A small grassy patch in the middle of the forest. There are tall pine trees surrounding the area. Sunlight filters down into the clearing, but the rest of the forest is obscured. 

 To the north is Midgard.

You can see Mistletoe here.

You'll have to get out of the Forest Clearing first.

>give mistletoe bucket
The mistletoe has no use for a plastic bucket.

>give mistletoe water
(first taking fountain water)
The mistletoe is pleased. You successfully convince the mistletoe not to hurt Baldr.

    *** You have won ***

Would you like to RESTART, RESTORE a saved game, QUIT or UNDO the last command?

>give mistletoe fountain water
Please give one of the answers above.

Would you like to RESTART, RESTORE a saved game, QUIT or UNDO the last command?

* * *

>n
Portal Room
A mostly empty room. The walls are all a bland grey and there are no windows. There is a bookshelf leaning against one of the walls. 

 To the south is the Underworld, Midgard it to the west, and there is a large gate to the north.

 
You can also see a large gate, a statue and Heimdallr here.

>give heimdallr horn
Heimdallr looks pleased. He decides to open the large gate for you.

* * *

>n
Valhalla
A good-sized room that looks like it has seen its fair share of parties. It isn't necessarily dirty, but everything is worn. 

 To the west is Asgard's Gate, to the south is the Portal Room.

You can see Asgard's Gate, a large gate and a centerpiece here.

You'll have to get out of Valhalla first.

>x opening
A small opening in the centerpiece, it appears to be closed.

* * *

>take horn
You stick the fishing pole into the water and skillfully maneuver the metal barb into the horn. With a quick motion, you bring the horn up to the surface and into your pocket.

>blow horn
You take a deep breath and blowing into Gjallarhorn. Pppbbttt. You make a noise similar to a loud fart. Maybe you should leave this to Heimdallr as he is no doubt better at this than you.

* * *

>combine barb with staff
You combine the metal barb and the staff to make a fishing pole. Although you probably won't use it to catch fish. Don't worry, there are other things in the river you can catch besides fish.

>n
Portal Room
A mostly empty room. The walls are all a bland grey and there are no windows. There is a bookshelf leaning against one of the walls. 

 To the south is the Underworld, Midgard it to the west, and there is a large gate to the north.

 
You can also see a large gate, a statue and Heimdallr here.

>use pole
You can't see anything you would want to use the fishing pole on.

>s
Underworld
A place that is surprisingly well lit for a place that seems so dark. A chilly wind makes you shiver. You can see the river Gjoll here. 

 To the north is the Portal Room.

You can see Hel's Gate here.

>use pole
You stick the fishing pole into the water and skillfully maneuver the metal barb into the horn. With a quick motion, you bring the horn up to the surface and into your pocket.

* * *

>x gate
While looking at Hel's Gate, you decide that Hel has very interesting decorating tastes. You notice that one of the metal barbs on the gate is loose. You can just reach it. When you hold it, you realize it is a little larger than you expected. It looks like you could combine this with something long to create some sort of fishing pole...

>combine pole and barb
You can't use multiple objects with that verb.

>combine pole with barb
You combine the metal barb and the pole to make a fishing pole. Although you probably won't use it to catch fish. Don't worry, there are other things in the river you can catch besides fish.

>take horn
You stick the fishing pole into the water and skillfully maneuver the metal barb into the horn. With a quick motion, you bring the horn up to the surface and into your pocket.

You already have that.

>i
You are carrying:
  Gjallarhorn
  a fishing pole

>n
Portal Room
A mostly empty room. The walls are all a bland grey and there are no windows. There is a bookshelf leaning against one of the walls. 

 To the south is the Underworld, Midgard it to the west, and there is a large gate to the north.

 
You can also see a large gate, a statue and Heimdallr here.

>give horn to heimdallr
Heimdallr looks pleased. He decides to open the large gate for you.

>n
Valhalla
A good-sized room that looks like it has seen its fair share of parties. It isn't necessarily dirty, but everything is worn. 

 To the west is Asgard's Gate, to the south is the Portal Room.

You can see Asgard's Gate, a large gate, a map and a centerpiece here.

You'll have to get out of Valhalla first.

>n
You can't go that way.

>s
(first opening the large gate)

Portal Room
A mostly empty room. The walls are all a bland grey and there are no windows. There is a bookshelf leaning against one of the walls. 

 To the south is the Underworld, Midgard it to the west, and there is a large gate to the north.

 
You can also see a large gate, a statue and Heimdallr here.

>talk to heimdallr
Heimdallr says he can't find his horn, Gjallarhorn. He seems pretty distraught about this. Is there anything else you would like to ask him?

>ask him to open the gate
I didn't understand that sentence.

>ask to open the gate
You can't see any such thing.

>ask about opening the gate
You can't see any such thing.

>ask heimdallr about opening the gate
He doesn't seem to want to open the gate.

>ask heimdallr about gate
He doesn't seem to want to open the gate.

>ask heimdallr about horn
Heimdallr says he does not remember, but it should be somewhere nearby.

>i
You are carrying:
  a fishing pole

>s
Underworld
A place that is surprisingly well lit for a place that seems so dark. A chilly wind makes you shiver. You can see the river Gjoll here. 

 To the north is the Portal Room.

You can see Hel's Gate here.

>take horn
You can't see any such thing.

>take gjallarhorn
You can't see any such thing.

>i
You are carrying:
  a fishing pole

* * *

>x gate
While looking at Hel's Gate, you decide that Hel has very interesting decorating tastes. You notice that one of the metal barbs on the gate is loose. You can just reach it. When you hold it, you realize it is a little larger than you expected. It looks like you could combine this with something long to create some sort of fishing pole...

>combine pole with barb
You combine the metal barb and the pole to make a fishing pole. Although you probably won't use it to catch fish. Don't worry, there are other things in the river you can catch besides fish.

* * *

>take horn
You stick the fishing pole into the water and skillfully maneuver the metal barb into the horn. With a quick motion, you bring the horn up to the surface and into your pocket.

You already have that.

>n
Portal Room
A mostly empty room. The walls are all a bland grey and there are no windows. There is a bookshelf leaning against one of the walls. 

 To the south is the Underworld, Midgard it to the west, and there is a large gate to the north.

 
You can also see a large gate, a statue and Heimdallr here.

* * *

>give heimdallr horn
Heimdallr looks pleased. He decides to open the large gate for you.

>n
Valhalla
A good-sized room that looks like it has seen its fair share of parties. It isn't necessarily dirty, but everything is worn. 

 To the west is Asgard's Gate, to the south is the Portal Room.

You can see Asgard's Gate, a large gate, a map and a centerpiece here.

You'll have to get out of Valhalla first.

>s
(first opening the large gate)

Portal Room
A mostly empty room. The walls are all a bland grey and there are no windows. There is a bookshelf leaning against one of the walls. 

 To the south is the Underworld, Midgard it to the west, and there is a large gate to the north.

 
You can also see a large gate, a statue and Heimdallr here.

>w
Midgard
 

You can see a bucket (empty) here.

* * *

>x gate
While looking at Hel's Gate, you decide that Hel has very interesting decorating tastes. You notice that one of the metal barbs on the gate is loose. You can just reach it. When you hold it, you realize it is a little larger than you expected. It looks like you could combine this with something long to create some sort of fishing pole...

>combine staff with barb
You combine the metal barb and the staff to make a fishing pole. Although you probably won't use it to catch fish. Don't worry, there are other things in the river you can catch besides fish.

>take horn
You stick the fishing pole into the water and skillfully maneuver the metal barb into the horn. With a quick motion, you bring the horn up to the surface and into your pocket.

* * *

>w
Midgard
You find yourself in a Midgardian janitor's closet. Which is to say, a regular janitor's closet. There are some trash bags and a mop lying next to the door you just came in. 

 To the south is a winding path and to the east is the Portal Room.

You can see a bucket (empty) here.

>take bucket
Taken.

>w
You can't go that way.

>e
Portal Room
A mostly empty room. The walls are all a bland grey and there are no windows. There is a bookshelf leaning against one of the walls. 

 To the south is the Underworld, Midgard it to the west, and there is a large gate to the north.

 
You can also see a large gate, a statue and Heimdallr here.

>give heimdallr horn
Heimdallr looks pleased. He decides to open the large gate for you.

>n
(first opening the large gate)

Valhalla
A good-sized room that looks like it has seen its fair share of parties. It isn't necessarily dirty, but everything is worn. 

 To the west is Asgard's Gate, to the south is the Portal Room.

You can see Asgard's Gate, a large gate and a centerpiece here.

>open center pieve
You can't see any such thing.

>open centerpiece
You open the centerpiece, revealing a map.

* * *

>take map
Taken.

>s
Portal Room
A mostly empty room. The walls are all a bland grey and there are no windows. There is a bookshelf leaning against one of the walls. 

 To the south is the Underworld, Midgard it to the west, and there is a large gate to the north.

 
You can also see a large gate, a statue and Heimdallr here.

* * *

>w
Midgard
You find yourself in a Midgardian janitor's closet. Which is to say, a regular janitor's closet. There are some trash bags and a mop lying next to the door you just came in. 

 To the south is a winding path and to the east is the Portal Room.

>s
You successfully navigate through the winding path, finding the forest clearing pointed out on the map.

Forest Clearing
A small grassy patch in the middle of the forest. There are tall pine trees surrounding the area. Sunlight filters down into the clearing, but the rest of the forest is obscured. 

 To the north is Midgard.

You can see Mistletoe and a golden key here.

>take key
Taken.

>n
Midgard
You find yourself in a Midgardian janitor's closet. Which is to say, a regular janitor's closet. There are some trash bags and a mop lying next to the door you just came in. 

 To the south is a winding path and to the east is the Portal Room.

>w
You can't go that way.

* * *

>e
Portal Room
A mostly empty room. The walls are all a bland grey and there are no windows. There is a bookshelf leaning against one of the walls. 

 To the south is the Underworld, Midgard it to the west, and there is a large gate to the north.

 
You can also see a large gate, a statue and Heimdallr here.

>n
Valhalla
A good-sized room that looks like it has seen its fair share of parties. It isn't necessarily dirty, but everything is worn. 

 To the west is Asgard's Gate, to the south is the Portal Room.

You can see Asgard's Gate, a large gate and a centerpiece (empty) here.

>w
(first opening Asgard's Gate)
It seems to be locked.

>unlock asgards gate with keyu
You can't see any such thing.

>>unlock asgards gate with keyu
That's not a verb I recognise.

>>unlock asgards gate with keyu
That's not a verb I recognise.

>unlock asgards gate with key
You unlock Asgard's Gate.

>open asgards gate
You open Asgard's Gate.

>w
Asgard
A grand place that is the city of the Gods. Unfortunately you aren't allowed any farther into the city, but from here you can access a large marble fountain, but that is about it. 

 To the east is Valhalla. 

You can see Asgard's Gate and a fountain (in which is fountain water) here.

>fill bucket with fountain water
You fill the bucket with water from the fountain.

>put book in bucket
You can't see any such thing.

>i
You are carrying:
  a golden key
  a map
  a bucket
    fountain water
  a fishing pole

>s
You can't go that way.

>e
Valhalla
A good-sized room that looks like it has seen its fair share of parties. It isn't necessarily dirty, but everything is worn. 

 To the west is Asgard's Gate, to the south is the Portal Room.

You can see Asgard's Gate, a large gate and a centerpiece (empty) here.

>s
Portal Room
A mostly empty room. The walls are all a bland grey and there are no windows. There is a bookshelf leaning against one of the walls. 

 To the south is the Underworld, Midgard it to the west, and there is a large gate to the north.

 
You can also see a large gate, a statue and Heimdallr here.

>take book
Taken.

>read book
What page do you want to read in the book?

>read page one in book
You read: " About the Ragnarok.  In Norse mythology, Ragnark is a series of events, including a great battle that will result in the death of a number of Gods. The Gods, understandably, don't want to die just yet, so they have appointed you to stop it. It is a great honor, they assure you, just don't fail. The Ragnarok officially begins when one of the Gods, Baldr, dies by being impaled with a spear covered in mistletoe, since it was the only living thing, in all of the nine realms, that hadn't been asked not to hurt Baldr. A minor oversight by Baldr's mother, who tried to prevent his death. In order to stop this from happening, you must convince the mistletoe not to harm Baldr."

>put book in bucket
Now the book is all wet. Way to go.

You put the wet old book into the bucket.

>put book in bucket
Now the book is all wet. Way to go.

(first taking the wet old book)

You put the wet old book into the bucket.

>i
You are carrying:
  a golden key
  a map
  a bucket
    a wet old book
    fountain water
  a fishing pole

>undo
Portal Room
[Previous turn undone.]

>undo
Portal Room
[Previous turn undone.]

>read page one in book
You read: " About the Ragnarok.  In Norse mythology, Ragnark is a series of events, including a great battle that will result in the death of a number of Gods. The Gods, understandably, don't want to die just yet, so they have appointed you to stop it. It is a great honor, they assure you, just don't fail. The Ragnarok officially begins when one of the Gods, Baldr, dies by being impaled with a spear covered in mistletoe, since it was the only living thing, in all of the nine realms, that hadn't been asked not to hurt Baldr. A minor oversight by Baldr's mother, who tried to prevent his death. In order to stop this from happening, you must convince the mistletoe not to harm Baldr."

* * *

>put book in bucket
Now the book is all wet. Way to go.

You put the wet old book into the bucket.

>read page one in book
You're not reading anything.

>x book
An ancient book that seems to be about the various myths and places in these worlds. It is soaking wet.

* * *

>n
(first opening the large gate)

Valhalla
A good-sized room that looks like it has seen its fair share of parties. It isn't necessarily dirty, but everything is worn. 

 To the west is Asgard's Gate, to the south is the Portal Room.

You can see Asgard's Gate, a large gate and a centerpiece here.

>open center piece
You open the centerpiece, revealing a map.

>take map
Taken.

* * *

>s
Portal Room
A mostly empty room. The walls are all a bland grey and there are no windows. There is a bookshelf leaning against one of the walls. 

 To the south is the Underworld, Midgard it to the west, and there is a large gate to the north.

 
You can also see a large gate, a statue and Heimdallr here.

>w
Midgard
You find yourself in a Midgardian janitor's closet. Which is to say, a regular janitor's closet. There are some trash bags and a mop lying next to the door you just came in. 

 To the south is a winding path and to the east is the Portal Room.

You can see a bucket (empty) here.

* * *

>take bucket
Taken.

>s
You successfully navigate through the winding path, finding the forest clearing pointed out on the map.

Forest Clearing
A small grassy patch in the middle of the forest. There are tall pine trees surrounding the area. Sunlight filters down into the clearing, but the rest of the forest is obscured. 

 To the north is Midgard.

You can see Mistletoe and a golden key here.

* * *

>n
Valhalla
A good-sized room that looks like it has seen its fair share of parties. It isn't necessarily dirty, but everything is worn. 

 To the west is Asgard's Gate, to the south is the Portal Room.

You can see Asgard's Gate, a large gate and a centerpiece (empty) here.

>unlock asgards gate
What do you want to unlock Asgard's Gate with?

* * *

>key
You unlock Asgard's Gate.

>open asgards gate
You open Asgard's Gate.

* * *

>w
Asgard
A grand place that is the city of the Gods. Unfortunately you aren't allowed any farther into the city, but from here you can access a large marble fountain, but that is about it. 

 To the east is Valhalla. 

You can see Asgard's Gate and a fountain (in which is fountain water) here.

>fill bucket
What do you want to fill the bucket with?

>fountain water
You fill the bucket with water from the fountain.

>e
Valhalla
A good-sized room that looks like it has seen its fair share of parties. It isn't necessarily dirty, but everything is worn. 

 To the west is Asgard's Gate, to the south is the Portal Room.

You can see Asgard's Gate, a large gate and a centerpiece (empty) here.

* * *

>w
Midgard
You find yourself in a Midgardian janitor's closet. Which is to say, a regular janitor's closet. There are some trash bags and a mop lying next to the door you just came in. 

 To the south is a winding path and to the east is the Portal Room.

>s
You successfully navigate through the winding path, finding the forest clearing pointed out on the map.

Forest Clearing
A small grassy patch in the middle of the forest. There are tall pine trees surrounding the area. Sunlight filters down into the clearing, but the rest of the forest is obscured. 

 To the north is Midgard.

You can see Mistletoe here.

>water mistletoe
The mistletoe is pleased. You successfully convince the mistletoe not to hurt Baldr.

    *** You have won ***

Would you like to RESTART, RESTORE a saved game, QUIT or UNDO the last command?

* * *

>talk to heimdallr
Heimdallr says he can't find his horn, Gjallarhorn. He seems pretty distraught about this. Is there anything else you would like to ask him about?

>break statue
You reach up and break off the staff that the statue was holding. It is a lot heavier than you expected, but still manageable.

* * *

>combine staff with barb
You combine the metal barb and the staff to make a fishing pole. Although you probably won't use it to catch fish. Don't worry, there are other things in the river you can catch besides fish.

>take horn
You stick the fishing pole into the water and skillfully maneuver the metal barb into the horn. With a quick motion, you bring the horn up to the surface and into your pocket.

You already have that.

* * *

>give heimdallr horn
Heimdallr looks pleased. He decides to open the large gate for you.

>talk to Heimdallr
Heimdallr thanks you for finding Gjallarhorn and invites you to go into Valhalla.

* * *

>break hand
You reach up and break off the staff that the statue was holding. It is a lot heavier than you expected, but still manageable.

* * *

>read book
What page do you want to read in the book?

>read page one in book
You're not reading anything.

>take all
There are none at all available!

>w
Midgard
You find yourself in a Midgardian janitor's closet. Which is to say, a regular janitor's closet. There are some trash bags and a mop lying next to the door you just came in. 

 To the south is a winding path and to the east is the Portal Room.

You can see a bucket (empty) here.

>take all
(the bucket)
Taken.

>e
Portal Room
A mostly empty room. The walls are all a bland grey and there are no windows. There is a bookshelf leaning against one of the walls. 

 To the south is the Underworld, Midgard it to the west, and there is a large gate to the north.

A long stone pole. It looks much heavier than it actually is.

 
You can also see a large gate, a statue and Heimdallr here.

>s
Underworld
A place that is surprisingly well lit for a place that seems so dark. A chilly wind makes you shiver. You can see the river Gjoll here. 

 To the north is the Portal Room.

You can see Hel's Gate here.

>take all
There are none at all available!

>x gate
While looking at Hel's Gate, you decide that Hel has very interesting decorating tastes. You notice that one of the metal barbs on the gate is loose. You can just reach it. When you hold it, you realize it is a little larger than you expected. It looks like you could combine this with something long to create some sort of fishing pole...

>n
Portal Room
A mostly empty room. The walls are all a bland grey and there are no windows. There is a bookshelf leaning against one of the walls. 

 To the south is the Underworld, Midgard it to the west, and there is a large gate to the north.

A long stone pole. It looks much heavier than it actually is.

 
You can also see a large gate, a statue and Heimdallr here.

>break statue
You reach up and break off the staff that the statue was holding. It is a lot heavier than you expected, but still manageable.

>combine staff with barb
You combine the metal barb and the staff to make a fishing pole. Although you probably won't use it to catch fish. Don't worry, there are other things in the river you can catch besides fish.

>s
Underworld
A place that is surprisingly well lit for a place that seems so dark. A chilly wind makes you shiver. You can see the river Gjoll here. 

 To the north is the Portal Room.

You can see Hel's Gate here.

>take horn
You stick the fishing pole into the water and skillfully maneuver the metal barb into the horn. With a quick motion, you bring the horn up to the surface and into your pocket.

* * *

>n
(first opening the large gate)

Valhalla
A good-sized room that looks like it has seen its fair share of parties. It isn't necessarily dirty, but everything is worn. 

 To the west is Asgard's Gate, to the south is the Portal Room.

You can see Asgard's Gate, a large gate and a centerpiece here.

>take all
There are none at all available!

>open centerpieve
You open the centerpiece, revealing a map.

>take map
Taken.

* * *

>s
You successfully navigate through the winding path, finding the forest clearing pointed out on the map.

Forest Clearing
A small grassy patch in the middle of the forest. There are tall pine trees surrounding the area. Sunlight filters down into the clearing, but the rest of the forest is obscured. 

 To the north is Midgard.

You can see Mistletoe and a golden key here.

>take all
There are none at all available!

>take key
Taken.

* * *

>x gate
A large gate that must be several stories high. It doesn't look like you are going to be able to open it without Heimdallr's consent.

>x stature
You can't see any such thing.

>x statue
A large stone statue of a tall bearded man holding a staff. It looks like part of the statue is starting to fall off. You can just make out hairline cracks near the hand holding the staff.

>break hand
You can't see any such thing.

>take staff
You can't see any such thing.

>take pole
You can't see any such thing.

>break pole
You can't see any such thing.

>hit pole
You can't see any such thing.

>pole
That's not a verb I recognise.

>grab pole
That's not a verb I recognise.

>grab staff
That's not a verb I recognise.

>break staff
You can't see any such thing.

>take staff
You can't see any such thing.

>hit staff
You can't see any such thing.

>break statue
You reach up and break off the staff that the statue was holding. It is a lot heavier than you expected, but still manageable.

>l
Portal Room
A mostly empty room. The walls are all a bland grey and there are no windows. There is a bookshelf leaning against one of the walls. 

 To the south is the Underworld, Midgard it to the west, and there is a large gate to the north.

 
You can also see a large gate, a statue and Heimdallr here.

>x bookshelf
A large wooden bookshelf. Mostly empty, except for an old dusty book on one of the rows.

In the bookshelf is an old book.

>x book
You see nothing special about the old book.

>take book
Taken.

* * *

I beg your pardon?

>read page 1
What do you want to read page that in?

>of book
You can't see any such thing.

>read page 1 of book
You read: " About the Ragnarok.  In Norse mythology, Ragnark is a series of events, including a great battle that will result in the death of a number of Gods. The Gods, understandably, don't want to die just yet, so they have appointed you to stop it. It is a great honor, they assure you, just don't fail. The Ragnarok officially begins when one of the Gods, Baldr, dies by being impaled with a spear covered in mistletoe. In order to stop this from happening, you must convince the mistletoe not to harm Baldr."

>read page 2 of book
You read: " About the Underworld.  The Underworld is Hel's domain. She doesn't appear to be there at the moment, but she left the gate open, allowing you to walk up to the river Gjoll. Heimdallr's horn, Gjallarhorn, comes from this river. However, the river Gjoll is said to feel like thousands of knives, so I wouldn't be to hasty to go swimming. Maybe if you had some sort of pole..."

>l
Portal Room
A mostly empty room. The walls are all a bland grey and there are no windows. There is a bookshelf leaning against one of the walls. 

 To the south is the Underworld, Midgard it to the west, and there is a large gate to the north.

 
You can also see a large gate, a statue and Heimdallr here.

>x heimdallr
A large, rather intimidating man. He looks unhappy. When asked, he says that he is missing Gjallarhorn, the horn from the river Gjoll.

>ask location of horn
You can't see any such thing.

>ask about location of horn
You can't see any such thing.

>ask man about horn
Heimdallr says he does not remember, but it should be somewhere nearby.

>go south
Underworld
A place that is surprisingly well lit for a place that seems so dark. A chilly wind makes you shiver. You can see the river Gjoll here. 

 To the north is the Portal Room.

You can see Hel's Gate here.

>x river
A flowing river that looks more intimidating than refreshing.

In Gjoll is Gjallarhorn.

>take horn
You stick your pole in the water, but you end up pushing Gjallarhorn around. Hmm, maybe if you had something sharp to combine with the pole.

>i
You are carrying:
  an old book
  a staff

>l
Underworld
A place that is surprisingly well lit for a place that seems so dark. A chilly wind makes you shiver. You can see the river Gjoll here. 

 To the north is the Portal Room.

You can see Hel's Gate here.

>x gate
While looking at Hel's Gate, you decide that Hel has very interesting decorating tastes. You notice that one of the metal barbs on the gate is loose. You can just reach it. When you hold it, you realize it is a little larger than you expected. It looks like you could combine this with something long to create some sort of fishing pole...

>take barb
You already have that.

>combine barb with pole
You can't see any such thing.

>x river
A flowing river that looks more intimidating than refreshing.

In Gjoll is Gjallarhorn.

* * *

>take horn
You stick your pole in the water, but you end up pushing Gjallarhorn around. Hmm, maybe if you had something sharp to combine with the pole.

>l
Underworld
A place that is surprisingly well lit for a place that seems so dark. A chilly wind makes you shiver. You can see the river Gjoll here. 

 To the north is the Portal Room.

You can see Hel's Gate here.

* * *

>x gate
While looking at Hel's Gate, you decide that Hel has very interesting decorating tastes. You notice that one of the metal barbs on the gate is loose. You can just reach it. When you hold it, you realize it is a little larger than you expected. It looks like you could combine this with something long to create some sort of fishing pole...

>north
Portal Room
A mostly empty room. The walls are all a bland grey and there are no windows. There is a bookshelf leaning against one of the walls. 

 To the south is the Underworld, Midgard it to the west, and there is a large gate to the north.

 
You can also see a large gate, a statue and Heimdallr here.

>read page 1 of book
You read: " About the Ragnarok.  In Norse mythology, Ragnark is a series of events, including a great battle that will result in the death of a number of Gods. The Gods, understandably, don't want to die just yet, so they have appointed you to stop it. It is a great honor, they assure you, just don't fail. The Ragnarok officially begins when one of the Gods, Baldr, dies by being impaled with a spear covered in mistletoe. In order to stop this from happening, you must convince the mistletoe not to harm Baldr."

* * *

>read page 2 of book
You read: " About the Underworld.  The Underworld is Hel's domain. She doesn't appear to be there at the moment, but she left the gate open, allowing you to walk up to the river Gjoll. Heimdallr's horn, Gjallarhorn, comes from this river. However, the river Gjoll is said to feel like thousands of knives, so I wouldn't be to hasty to go swimming. Maybe if you had some sort of pole..."

>x man
A large, rather intimidating man. He looks unhappy. When asked, he says that he is missing Gjallarhorn, the horn from the river Gjoll.

>give man horn
You can't see any such thing.

>thankeee
That's not a verb I recognise.

>l
Portal Room
A mostly empty room. The walls are all a bland grey and there are no windows. There is a bookshelf leaning against one of the walls. 

 To the south is the Underworld, Midgard it to the west, and there is a large gate to the north.

 
You can also see a large gate, a statue and Heimdallr here.

>read page 3 of book
You read: " About Midgard.  For the time being, the Gods have restricted the accessible area of your homeworld to a janitor's closet and a small forest just outside. They say it is incentive for you to work faster. Not everything here is trash, though, and you may even find something to help you on your journey."

>north
It seems Heimdallr doesn't want you going in there.

>x gate
A large gate that must be several stories high. It doesn't look like you are going to be able to open it without Heimdallr's consent.

>x asgards gate
You can't see any such thing.

>x large gate
A large gate that must be several stories high. It doesn't look like you are going to be able to open it without Heimdallr's consent.

>x map
You can't see any such thing.

>x centerpiece
You can't see any such thing.

>x map
You can't see any such thing.

>take map
You can't see any such thing.

>take centerpiece
You can't see any such thing.

>x center piece
You can't see any such thing.

>x centerpiece
You can't see any such thing.

>l
Portal Room
A mostly empty room. The walls are all a bland grey and there are no windows. There is a bookshelf leaning against one of the walls. 

 To the south is the Underworld, Midgard it to the west, and there is a large gate to the north.

 
You can also see a large gate, a statue and Heimdallr here.

>west
Midgard
You find yourself in a Midgardian janitor's closet. Which is to say, a regular janitor's closet. There are some trash bags and a mop lying next to the door you just came in. 

 To the south is a winding path and to the east is the Portal Room.

You can see a bucket (empty) here.

>south
The forest looks thick and unwelcoming. It would be foolish to enter without a map.

>talk to man
You can't see any such thing.

>give man hron
You can't see any such thing.

>give man horn
You can't see any such thing.

>l
Midgard
You find yourself in a Midgardian janitor's closet. Which is to say, a regular janitor's closet. There are some trash bags and a mop lying next to the door you just came in. 

 To the south is a winding path and to the east is the Portal Room.

You can see a bucket (empty) here.

>west
You can't go that way.

>read page 3 of book
You read: " About Midgard.  For the time being, the Gods have restricted the accessible area of your homeworld to a janitor's closet and a small forest just outside. They say it is incentive for you to work faster. Not everything here is trash, though, and you may even find something to help you on your journey."

>l
Midgard
You find yourself in a Midgardian janitor's closet. Which is to say, a regular janitor's closet. There are some trash bags and a mop lying next to the door you just came in. 

 To the south is a winding path and to the east is the Portal Room.

You can see a bucket (empty) here.

>x trash bags
Large garbage bags filled with who-knows-what. You can smell it from several feet away.

>x trash
Large garbage bags filled with who-knows-what. You can smell it from several feet away.

>take bags
I wouldn't want to touch that unless you want to smell like garbage for the rest of the week.

>take trash bags
I wouldn't want to touch that unless you want to smell like garbage for the rest of the week.

>x mop
A blue and white dust mop.

>take mop
You probably won't be cleaning where you are going.

>x bucket
A medium sized plastic bucket.

>take bucket
Taken.

>read page 4 of book
The section on Valhalla seems to be unreadable as of now. Maybe you will be able to read this farther along your adventure.

>read next page
What do you want to read that in?

>book
The section on Valhalla seems to be unreadable as of now. Maybe you will be able to read this farther along your adventure.

>east
Portal Room
A mostly empty room. The walls are all a bland grey and there are no windows. There is a bookshelf leaning against one of the walls. 

 To the south is the Underworld, Midgard it to the west, and there is a large gate to the north.

 
You can also see a large gate, a statue and Heimdallr here.

>arge
That's not a verb I recognise.

>north
It seems Heimdallr doesn't want you going in there.

>read page 5 of booj
You can't see any such thing.

>read page 5 of book
The section on the forest seems to be unreadable as of now. Maybe you will be able to read this farther along your adventure.

>l
Portal Room
A mostly empty room. The walls are all a bland grey and there are no windows. There is a bookshelf leaning against one of the walls. 

 To the south is the Underworld, Midgard it to the west, and there is a large gate to the north.

 
You can also see a large gate, a statue and Heimdallr here.

>i
You are carrying:
  a bucket
  a metal barb
  an old book
  a staff

>south
Underworld
A place that is surprisingly well lit for a place that seems so dark. A chilly wind makes you shiver. You can see the river Gjoll here. 

 To the north is the Portal Room.

You can see Hel's Gate here.

>north
Portal Room
A mostly empty room. The walls are all a bland grey and there are no windows. There is a bookshelf leaning against one of the walls. 

 To the south is the Underworld, Midgard it to the west, and there is a large gate to the north.

 
You can also see a large gate, a statue and Heimdallr here.

>south
Underworld
A place that is surprisingly well lit for a place that seems so dark. A chilly wind makes you shiver. You can see the river Gjoll here. 

 To the north is the Portal Room.

You can see Hel's Gate here.

>sough
That's not a verb I recognise.

>south
You can't go that way.

>north
Portal Room
A mostly empty room. The walls are all a bland grey and there are no windows. There is a bookshelf leaning against one of the walls. 

 To the south is the Underworld, Midgard it to the west, and there is a large gate to the north.

 
You can also see a large gate, a statue and Heimdallr here.

>west
Midgard
You find yourself in a Midgardian janitor's closet. Which is to say, a regular janitor's closet. There are some trash bags and a mop lying next to the door you just came in. 

 To the south is a winding path and to the east is the Portal Room.

>south
The forest looks thick and unwelcoming. It would be foolish to enter without a map.

>x trees
You can't see any such thing.

>x forest
You can't see any such thing.

>x grassy patch
You can't see any such thing.

>x sunlight
You can't see any such thing.

>x key
You can't see any such thing.

>x golden key
You can't see any such thing.

>take key
You can't see any such thing.

>x mistletoe
You can't see any such thing.

>take mistetoe
You can't see any such thing.

>take mistletoe
You can't see any such thing.

>read page 1 of book
You read: " About the Ragnarok.  In Norse mythology, Ragnark is a series of events, including a great battle that will result in the death of a number of Gods. The Gods, understandably, don't want to die just yet, so they have appointed you to stop it. It is a great honor, they assure you, just don't fail. The Ragnarok officially begins when one of the Gods, Baldr, dies by being impaled with a spear covered in mistletoe. In order to stop this from happening, you must convince the mistletoe not to harm Baldr."

>take to mistletoe
You can't see any such thing.

>talk to mistletoe
You can't see any such thing.

>l
Midgard
You find yourself in a Midgardian janitor's closet. Which is to say, a regular janitor's closet. There are some trash bags and a mop lying next to the door you just came in. 

 To the south is a winding path and to the east is the Portal Room.

>north
You can't go that way.

>read page 5 of book
The section on the forest seems to be unreadable as of now. Maybe you will be able to read this farther along your adventure.

>read page 4
What do you want to read page that in?

>book
The section on Valhalla seems to be unreadable as of now. Maybe you will be able to read this farther along your adventure.

>read page 6
What do you want to read page that in?

>book
The section on Asgard seems to be unreadable as of now. Maybe you will be able to read this farther along your adventure.

>north
You can't go that way.

>south
The forest looks thick and unwelcoming. It would be foolish to enter without a map.

>east
Portal Room
A mostly empty room. The walls are all a bland grey and there are no windows. There is a bookshelf leaning against one of the walls. 

 To the south is the Underworld, Midgard it to the west, and there is a large gate to the north.

 
You can also see a large gate, a statue and Heimdallr here.

>west
Midgard
You find yourself in a Midgardian janitor's closet. Which is to say, a regular janitor's closet. There are some trash bags and a mop lying next to the door you just came in. 

 To the south is a winding path and to the east is the Portal Room.

>north
You can't go that way.

>east
Portal Room
A mostly empty room. The walls are all a bland grey and there are no windows. There is a bookshelf leaning against one of the walls. 

 To the south is the Underworld, Midgard it to the west, and there is a large gate to the north.

 
You can also see a large gate, a statue and Heimdallr here.

>north
It seems Heimdallr doesn't want you going in there.

>x asgards gate
You can't see any such thing.

>open asgards gate
You can't see any such thing.

>unlock asgards gate
You can't see any such thing.

>key
That's not a verb I recognise.

>west
Midgard
You find yourself in a Midgardian janitor's closet. Which is to say, a regular janitor's closet. There are some trash bags and a mop lying next to the door you just came in. 

 To the south is a winding path and to the east is the Portal Room.

>x fountain
You can't see any such thing.

>fountain
That's not a verb I recognise.

>fountain water
That's not a verb I recognise.

>drink water
You can't see any such thing.

>read page 1 in book
You read: " About the Ragnarok.  In Norse mythology, Ragnark is a series of events, including a great battle that will result in the death of a number of Gods. The Gods, understandably, don't want to die just yet, so they have appointed you to stop it. It is a great honor, they assure you, just don't fail. The Ragnarok officially begins when one of the Gods, Baldr, dies by being impaled with a spear covered in mistletoe. In order to stop this from happening, you must convince the mistletoe not to harm Baldr."

>read page 6 in book
The section on Asgard seems to be unreadable as of now. Maybe you will be able to read this farther along your adventure.

>i
You are carrying:
  a bucket
  a metal barb
  an old book
  a staff

>fill bucket with fountain water
You can't see any such thing.

* * *

>use horn
You can't see any such thing.

>break statue
You reach up and break off the staff that the statue was holding. It is a lot heavier than you expected, but still manageable.

* * *

>n
Portal Room
A mostly empty room. The walls are all a bland grey and there are no windows. There is a bookshelf leaning against one of the walls. 

 To the south is the Underworld, Midgard it to the west, and there is a large gate to the north.

 
You can also see a large gate, a statue and Heimdallr here.

>use pole
You stick the fishing pole into the water and skillfully maneuver the metal barb into the horn. With a quick motion, you bring the horn up to the surface and into your pocket.

* * *

>x me
You are a human of average height and weight. You are a generally average person, not having done any astounding feats of bravery, or seen anything particularly extraordinary. Maybe your wish for adventure will soon be fulfilled.

* * *

>take book
Taken.

>read page one in book
You read: " About the Ragnarok.  In Norse mythology, Ragnark is a series of events, including a great battle that will result in the death of a number of Gods. The Gods, understandably, don't want to die just yet, so they have appointed you to stop it. It is a great honor, they assure you, just don't fail. The Ragnarok officially begins when one of the Gods, Baldr, dies by being impaled with a spear covered in mistletoe, since it was the only living thing, in all of the nine realms, that hadn't been asked not to hurt Baldr. A minor oversight by Baldr's mother, who tried to prevent his death. In order to stop this from happening, you must convince the mistletoe not to harm Baldr."

>s
Underworld
A place that is surprisingly well lit for a place that seems so dark. A chilly wind makes you shiver. You can see the river Gjoll here. 

 To the north is the Portal Room.

You can see Hel's Gate here.

* * *

>x gate
While looking at Hel's Gate, you decide that Hel has very interesting decorating tastes. You notice that one of the metal barbs on the gate is loose. You can just reach it. When you hold it, you realize it is a little larger than you expected. It looks like you could combine this with something long to create some sort of fishing pole...

>comine staff and barb
That's not a verb I recognise.

>combine staff with barb
You can't see any such thing.

>n
Portal Room
A mostly empty room. The walls are all a bland grey and there are no windows. There is a bookshelf leaning against one of the walls. 

 To the south is the Underworld, Midgard it to the west, and there is a large gate to the north.

A long stone pole. It looks much heavier than it actually is.

 
You can also see a large gate, a statue and Heimdallr here.

* * *

>s
Underworld
A place that is surprisingly well lit for a place that seems so dark. A chilly wind makes you shiver. You can see the river Gjoll here. 

 To the north is the Portal Room.

You can see Hel's Gate here.

>combine staff and barb
You can't use multiple objects with that verb.

>combine staff with barb
You combine the metal barb and the staff to make a fishing pole. Although you probably won't use it to catch fish. Don't worry, there are other things in the river you can catch besides fish.

* * *

>n
(first opening the large gate)

Valhalla
A good-sized room that looks like it has seen its fair share of parties. It isn't necessarily dirty, but everything is worn. 

 To the west is Asgard's Gate, to the south is the Portal Room.

You can see Asgard's Gate, a large gate and a centerpiece here.

>open centerpiece
You open the centerpiece, revealing a map.

* * *

>fountain water
You fill the bucket with water from the fountain.

>read page one in book
You read: " About the Ragnarok.  In Norse mythology, Ragnark is a series of events, including a great battle that will result in the death of a number of Gods. The Gods, understandably, don't want to die just yet, so they have appointed you to stop it. It is a great honor, they assure you, just don't fail. The Ragnarok officially begins when one of the Gods, Baldr, dies by being impaled with a spear covered in mistletoe, since it was the only living thing, in all of the nine realms, that hadn't been asked not to hurt Baldr. A minor oversight by Baldr's mother, who tried to prevent his death. In order to stop this from happening, you must convince the mistletoe not to harm Baldr."

* * *

>put book in bucket
Now the book is all wet. Way to go.

You put the wet old book into the bucket.

>read page one in book
You're not reading anything.
The book is too soaked to read, thanks to your carelessness.

>restart
Are you sure you want to restart?

* * *

>x bookshelf
A large wooden bookshelf. Mostly empty, except for an old dusty book on one of the rows.

In the bookshelf is an old book.

* * *

>take book
Taken.

>x me
As good-looking as ever.

>x gate
A large gate that must be several stories high. It doesn't look like you are going to be able to open it without Heimdallr's consent.

>x statue
A large stone statue of a tall bearded man holding a staff. It looks like part of the statue is starting to fall off. You can just make out hairline cracks near the hand holding the staff.

>x staff
You can't see any such thing.

>attack statue
You reach up and break off the staff that the statue was holding. It is a lot heavier than you expected, but still manageable.

>x staff
You see nothing special about the staff.

>take staff
you are going to need to use more force to do that.

>x Heimdallt
You can't see any such thing.

>x Heimdallr
A large, rather intimidating man. He looks unhappy. When asked, he says that he is missing Gjallarhorn, the horn from the river Gjoll.

>attack Heimdallr
    *** It wasn't a very smart choice to attack a god. You find yourself unable to continue your adventure. ***

Would you like to RESTART, RESTORE a saved game, QUIT or UNDO the last command?

>undo
Portal Room
[Previous turn undone.]

>l
Portal Room
A mostly empty room. The walls are all a bland grey and there are no windows. There is a bookshelf leaning against one of the walls. 

 To the south is the Underworld, Midgard it to the west, and there is a large gate to the north.

 
You can also see a large gate, a statue and Heimdallr here.

>x walls
You can't see any such thing.

>s
Underworld
A place that is surprisingly well lit for a place that seems so dark. A chilly wind makes you shiver. You can see the river Gjoll here. 

 To the north is the Portal Room.

You can see Hel's Gate here.

>x river
A flowing river that looks more intimidating than refreshing.

In Gjoll is Gjallarhorn.

>take Gjallarhorn
You stick your pole in the water, but you end up pushing Gjallarhorn around. Hmm, maybe if you had something sharp to combine with the pole.

>x gate
While looking at Hel's Gate, you decide that Hel has very interesting decorating tastes. You notice that one of the metal barbs on the gate is loose. You can just reach it. When you hold it, you realize it is a little larger than you expected. It looks like you could combine this with something long to create some sort of fishing pole...

>i
You are carrying:
  a metal barb
  a staff
  an old book

>combine barb with staff
You combine the metal barb and the staff to make a fishing pole. Although you probably won't use it to catch fish. Don't worry, there are other things in the river you can catch besides fish.

>take Gjallarhorn
You stick the fishing pole into the water and skillfully maneuver the metal barb into the horn. With a quick motion, you bring the horn up to the surface and into your pocket.

>l
Underworld
A place that is surprisingly well lit for a place that seems so dark. A chilly wind makes you shiver. You can see the river Gjoll here. 

 To the north is the Portal Room.

You can see Hel's Gate here.

>n
Portal Room
A mostly empty room. The walls are all a bland grey and there are no windows. There is a bookshelf leaning against one of the walls. 

 To the south is the Underworld, Midgard it to the west, and there is a large gate to the north.

 
You can also see a large gate, a statue and Heimdallr here.

>give Heimdallar Gjallarhorn
You can't see any such thing.

>give Heimdallr Gjallarhorn
Heimdallr looks pleased. He decides to open the large gate for you.

>l
Portal Room
A mostly empty room. The walls are all a bland grey and there are no windows. There is a bookshelf leaning against one of the walls. 

 To the south is the Underworld, Midgard it to the west, and there is a large gate to the north.

 
You can also see a large gate, a statue and Heimdallr here.

>w
Midgard
You find yourself in a Midgardian janitor's closet. Which is to say, a regular janitor's closet. There are some trash bags and a mop lying next to the door you just came in. 

 To the south is a winding path and to the east is the Portal Room.

You can see a bucket (empty) here.

>x bags
Large garbage bags filled with who-knows-what. You can smell it from several feet away.

>take bags
I wouldn't want to touch that unless you want to smell like garbage for the rest of the week.

>x mop
A blue and white dust mop.

* * *

>take bucket
Taken.

>i
You are carrying:
  a bucket
  a fishing pole
  an old book

>put book in bucket
You put the old book into the bucket.

>put fishing in bucket
You put the fishing pole into the bucket.

>s
The forest looks thick and unwelcoming. It would be foolish to enter without a map.

>x path
You can't see any such thing.

>e
Portal Room
A mostly empty room. The walls are all a bland grey and there are no windows. There is a bookshelf leaning against one of the walls. 

 To the south is the Underworld, Midgard it to the west, and there is a large gate to the north.

 
You can also see a large gate, a statue and Heimdallr here.

>n
Valhalla
A good-sized room that looks like it has seen its fair share of parties. It isn't necessarily dirty, but everything is worn. 

 To the west is Asgard's Gate, to the south is the Portal Room.

You can see Asgard's Gate, a large gate and a centerpiece here.

You'll have to get out of Valhalla first.

I beg your pardon?

>x gate
Which do you mean, Asgard's Gate or the large gate?

>x Asgard's gate
A large ornate golden gate. It is decorated almost to the point of being ridiculously cheesy. You almost expect to hear a choir singing when you look at it.

>w
(first opening Asgard's Gate)
It seems to be locked.

>x large gate
A large gate that must be several stories high. It doesn't look like you are going to be able to open it without Heimdallr's consent.

>x centerpiece
An intricate centerpiece showing what appears to be several of the worlds you have visited suspended on a the branches of a tree. Upon further inspection you can see there is a small opening

>x opening
You can't see any such thing.

>enter centerpeice
You can't see any such thing.

>enter centerpiece
That's not something you can enter.

>take centerpiece
A nice floral centerpiece plated in gold. It seems very expensive, probably worth more than you. I wouldn't take it if I were you. Have you tried taking a closer look?

>take all
centerpiece: A nice floral centerpiece plated in gold. It seems very expensive, probably worth more than you. I wouldn't take it if I were you. Have you tried taking a closer look?
fishing pole: Taken.
old book: Taken.

>open centerpiece
You open the centerpiece, revealing a map.

* * *

>take map
Taken.

>x map
A map of Midgard and its surrounding forests, there seems to be a clearing pointed out just south of Midgard.

>l
Valhalla
A good-sized room that looks like it has seen its fair share of parties. It isn't necessarily dirty, but everything is worn. 

 To the west is Asgard's Gate, to the south is the Portal Room.

You can see Asgard's Gate, a large gate and a centerpiece (empty) here.

>s
(first opening the large gate)

Portal Room
A mostly empty room. The walls are all a bland grey and there are no windows. There is a bookshelf leaning against one of the walls. 

 To the south is the Underworld, Midgard it to the west, and there is a large gate to the north.

 
You can also see a large gate, a statue and Heimdallr here.

* * *

>s
You successfully navigate through the winding path, finding the forest clearing pointed out on the map.

Forest Clearing
A small grassy patch in the middle of the forest. There are tall pine trees surrounding the area. Sunlight filters down into the clearing, but the rest of the forest is obscured. 

 To the north is Midgard.

A large ornate golden key. It looks like it would fit into a large ornate golden gate.

You can also see Mistletoe here.

You'll have to get out of the Forest Clearing first.

>x trees
Large pine trees that seem to stretch on forever.

>x key
You see nothing special about the golden key.

>take key
Taken.

>x mistletoe
A small green plant. It looks pretty harmless in its current state.

>take mistletoe
I don't suppose Mistletoe would care for that.

>n
Midgard
You find yourself in a Midgardian janitor's closet. Which is to say, a regular janitor's closet. There are some trash bags and a mop lying next to the door you just came in. 

 To the south is a winding path and to the east is the Portal Room.

* * *

>n
Valhalla
A good-sized room that looks like it has seen its fair share of parties. It isn't necessarily dirty, but everything is worn. 

 To the west is Asgard's Gate, to the south is the Portal Room.

You can see Asgard's Gate, a large gate and a centerpiece (empty) here.

You'll have to get out of Valhalla first.

>w
(first opening Asgard's Gate)
It seems to be locked.

>unlock Asgard's Gate
What do you want to unlock Asgard's Gate with?

>unlock Asgard's Gate with key
You unlock Asgard's Gate.

>w
(first opening Asgard's Gate)

Asgard
A grand place that is the city of the Gods. Unfortunately you aren't allowed any farther into the city, but from here you can access a large marble fountain, but that is about it. 

 To the west is Valhalla. 

You can see Asgard's Gate and a fountain (in which is fountain water) here.

>x fountain
(the fountain)
A huge marble fountain depicting a man trying to catch a fish with his bare hands. Water shoots out of the fish's mouth into the large circular area surrounding the fountain.

In the fountain is fountain water.

>x water
You see nothing special about fountain water.

>i
You are carrying:
  a golden key
  a map
  an old book
  a fishing pole
  a bucket

>put water in bucket
(first taking fountain water)

You put fountain water into the bucket.

>i
You are carrying:
  a golden key
  a map
  an old book
  a fishing pole
  a bucket
    fountain water

>put book in bucket
You put the old book into the bucket.

>x book
You see nothing special about the old book.

>l
Asgard
A grand place that is the city of the Gods. Unfortunately you aren't allowed any farther into the city, but from here you can access a large marble fountain, but that is about it. 

 To the west is Valhalla. 

You can see Asgard's Gate and a fountain (empty) here.

>drink water
Although it is tempting, you have more important matters to get to.

>w
You can't go that way.

>w
You can't go that way.

>e
Valhalla
A good-sized room that looks like it has seen its fair share of parties. It isn't necessarily dirty, but everything is worn. 

 To the west is Asgard's Gate, to the south is the Portal Room.

You can see Asgard's Gate, a large gate and a centerpiece (empty) here.

You'll have to get out of Valhalla first.

* * *

>s
Portal Room
A mostly empty room. The walls are all a bland grey and there are no windows. There is a bookshelf leaning against one of the walls. 

 To the south is the Underworld, Midgard it to the west, and there is a large gate to the north.

 
You can also see a large gate, a statue and Heimdallr here.

>x Heimdallr
A large, rather intimidating man. He looks pleased. When asked, he says that he is missing Gjallarhorn, the horn from the river Gjoll.

>s
Underworld
A place that is surprisingly well lit for a place that seems so dark. A chilly wind makes you shiver. You can see the river Gjoll here. 

 To the north is the Portal Room.

You can see Hel's Gate here.

* * *

>x gate
While looking at Hel's Gate, you decide that Hel has very interesting decorating tastes. You notice that one of the metal barbs on the gate is loose. You can just reach it. When you hold it, you realize it is a little larger than you expected. It looks like you could combine this with something long to create some sort of fishing pole...

>i
You are carrying:
  a metal barb
  a golden key
  a map
  a fishing pole
  a bucket
    an old book
    fountain water

>n
Portal Room
A mostly empty room. The walls are all a bland grey and there are no windows. There is a bookshelf leaning against one of the walls. 

 To the south is the Underworld, Midgard it to the west, and there is a large gate to the north.

 
You can also see a large gate, a statue and Heimdallr here.

>attack bookshelf
Violence isn't the answer to this one.

>s
Underworld
A place that is surprisingly well lit for a place that seems so dark. A chilly wind makes you shiver. You can see the river Gjoll here. 

 To the north is the Portal Room.

You can see Hel's Gate here.

>nw
You can't go that way.

>n
Portal Room
A mostly empty room. The walls are all a bland grey and there are no windows. There is a bookshelf leaning against one of the walls. 

 To the south is the Underworld, Midgard it to the west, and there is a large gate to the north.

 
You can also see a large gate, a statue and Heimdallr here.

>w
Midgard
You find yourself in a Midgardian janitor's closet. Which is to say, a regular janitor's closet. There are some trash bags and a mop lying next to the door you just came in. 

 To the south is a winding path and to the east is the Portal Room.

* * *

>s
You successfully navigate through the winding path, finding the forest clearing pointed out on the map.

Forest Clearing
A small grassy patch in the middle of the forest. There are tall pine trees surrounding the area. Sunlight filters down into the clearing, but the rest of the forest is obscured. 

 To the north is Midgard.

You can see Mistletoe here.

You'll have to get out of the Forest Clearing first.

>x mistletoe
A small green plant. It looks pretty harmless in its current state.

>put water on mistletoe
(first taking fountain water)

Putting things on Mistletoe would achieve nothing.

>water misteltoe
That's not a verb I recognise.

>i
You are carrying:
  fountain water
  a metal barb
  a golden key
  a map
  a fishing pole
  a bucket
    an old book

>read book
You should have a page number before the read command.

>read book 1
I didn't understand that number.

>give misteltoe water
You can't see any such thing.

>give mistletoe water
The mistletoe is pleased. You successfully convince the mistletoe not to hurt Baldr.

    *** You have won ***

Would you like to RESTART, RESTORE a saved game, QUIT or UNDO the last command?

>undo
Forest Clearing
[Previous turn undone.]

>reaad first page of book
That's not a verb I recognise.

>read page 1 of book
You're not reading anything.

>restart
Are you sure you want to restart?