You wake up in a strange room, not entirely knowing why you are here, or even where you are. There isn't much in the room to suggest why you are here, maybe you can find something in this room to help you remember.

Ragnarok
An Interactive Fiction by Marissa Takebayashi
Release 1 / Serial number 140305 / Inform 7 build 6G60 (I6/v6.32 lib 6/12N) SD

Portal Room
A mostly empty room. The walls are all a bland grey and there are no windows. There is a bookshelf leaning against one of the walls. 

 To the south is the Underworld, Midgard it to the west, and there is a large gate to the north.

 
You can also see a large gate, a statue and Heimdallr here.

>s
Underworld

* * *

>n
Portal Room
 

 

You can also see a large gate and Heimdallr here.

>take book
Taken.

* * *

>s
Underworld

>n
Portal Room
 

You can see a large gate and Heimdallr here.

>e
You can't go that way.

>w
Midgard

>e
Portal Room
 

You can see a large gate and Heimdallr here.

>s
It seems to be locked.

>x large gate
 gsdhfj

* * *

>w
Midgard

>s
Forest Clearing

* * *

>n
Portal Room
 

You can see a large gate and Heimdallr here.

>w
Midgard

* * *

>s
Forest Clearing

>n
Midgard

>e
Portal Room
 

You can see a large gate and Heimdallr here.

>n
(first opening the large gate)

Valhalla
 

 

You can also see Asgard's Gate and a large gate here.

* * *

>s
Underworld

>unlock gatw
You can't see any such thing.

>unlock large gate
What do you want to unlock the large gate with?

>golden key
You can't see any such thing.

* * *

>ask heimdallr to open gate
I didn't understand that sentence.

>ask heimdallr for open gate
You can't see any such thing.

* * *

>break statue
You reach up and break off the staff that the statue was holding. It is a lot heavier than you expected, but still manageable.

* * *

>s
Underworld
A place that is surprisingly well lit for a place that seems so dark. A chilly wind makes you shiver. You can see the river Gjoll here. 

 To the north is the Portal Room.

You can see Hel's Gate here.

>take horn
Gjallarhorn is at the bottom of the river, your arms are too short to reach it from here. Maybe if you had something to fish it out of the river...

>x gate
While looking at Hel's Gate, you decide that Hel has very interesting decorating tastes. You notice that one of the metal barbs on the gate is loose. You can just reach it. When you hold it, you realize it is a little larger than you expected. It looks like you could combine this with something long to create some sort of fishing pole...

>i
You are carrying:
  a metal barb

>n
Portal Room
A mostly empty room. The walls are all a bland grey and there are no windows. There is a bookshelf leaning against one of the walls.

A long stone pole. It looks much heavier than it actually is.

You can also see a large gate, a statue, a bookshelf (in which is an old book) and Heimdallr here.

>take pole
Taken.

>break statue
Violence isn't the answer to this one.

>combine pole with barb
You combine the metal barb and the pole to make a fishing pole. Although you probably won't use it to catch fish. Don't worry, there are other things in the river you can catch besides fish.

>s
Underworld

>take horn
You stick the fishing pole into the water and skillfully maneuver the metal barb into the horn. With a quick motion, you bring the horn up to the surface and into your pocket.

You already have that.

* * *

>i
You are carrying:
  Gjallarhorn
  a fishing pole

>n
Portal Room
A mostly empty room. The walls are all a bland grey and there are no windows. There is a bookshelf leaning against one of the walls.

You can see a large gate, a statue, a bookshelf (in which is an old book) and Heimdallr here.

>give horn to heimdallr
Heimdallr looks pleased. He decides to open the large gate for you.

>n
Valhalla
 

You can see Asgard's Gate, a large gate, a map and a centerpiece here.

You'll have to get out of Valhalla first.

>x centerpiece
An intricate centerpiece showing what appears to be several of the worlds you have visited. Upon further inspection you can see there is a map attached.

>take map
Taken.

>e
You can't go that way.

>w
(first opening Asgard's Gate)
It seems to be locked.

>s
(first opening the large gate)

Portal Room
A mostly empty room. The walls are all a bland grey and there are no windows. There is a bookshelf leaning against one of the walls.

You can see a large gate, a statue, a bookshelf (in which is an old book) and Heimdallr here.

>w
Midgard
 

You can see a bucket (empty) here.

>take bucket
Taken.

>s
You successfully navigate through the winding path, finding the forest clearing pointed out on the map.

Forest Clearing
A small grassy patch in the middle of the forest. There are tall pine trees surrounding the area. Sunlight filters down into the clearing, but the rest of the forest is obscured.

A large ornate golden key. It looks like it would fit into a large ornate golden gate.

You'll have to get out of the Forest Clearing first.

>take key
Taken.

>n
Midgard

>e
Portal Room
A mostly empty room. The walls are all a bland grey and there are no windows. There is a bookshelf leaning against one of the walls.

You can see a large gate, a statue, a bookshelf (in which is an old book) and Heimdallr here.

>n
Valhalla
 

You can see Asgard's Gate, a large gate and a centerpiece here.

You'll have to get out of Valhalla first.

>w
(first opening Asgard's Gate)
It seems to be locked.

>unlock gate
Which do you mean, Asgard's Gate or the large gate?

>Asgard's gate
What do you want to unlock Asgard's Gate with?

>key
You unlock Asgard's Gate.

* * *

>open gate
Which do you mean, Asgard's Gate or the large gate?

>asgard's gate
You open Asgard's Gate.

>w
Asgard
 

You can see Asgard's Gate here.

>fill bucket with fountain wate
You can't see any such thing.

>rfill bucket with fountain water
That's not a verb I recognise.

>fill bucket with fountain water
You fill the bucket with water from the fountain.

* * *

>break statue
You reach up and break off the staff that the statue was holding. It is a lot heavier than you expected, but still manageable.

>breaking statue
That's not a verb I recognise.

* * *

>x bookshelf
A large wooden bookshelf. Mostly empty, except for an old dusty book on one of the rows.

In the bookshelf is an old book.

>take book
Taken.

>break statue
You reach up and break off the staff that the statue was holding.

>talk to heimdally
That's not a verb I recognise.

>take to heimdallr
You can't see any such thing.

>talk to heimdallr
That's not a verb I recognise.

* * *

>take bookshelf
I don't think you can carry that.

* * *

>n
kgkj

>s
Underworld
 

You can see Gjallarhorn here.

>n
Portal Room
 

You can see a large gate and Heimdallr here.

* * *

>take book
Taken.

>read pg 2
You can't see any such thing.

* * *

>take book
Taken.

>read page 2
(in the old book)
You read: " About the Underworld.  The Underworld is Hel's domain. She doesn't appear to be there at the moment, but she left the gate open, allowing you to walk up to the river Gjoll. Heimdallr's horn, Gjallarhorn, comes from this river. "

>read first page
(in the old book)
You read: " About the Ragnarok.  In Norse mythology, Ragnarök is a series of events, including a great battle that will result in the death of a number of Gods. The Gods, understandably, don't want to die just yet, so they have appointed you to stop it. It is a great honor, they assure you, just don't fail. The Ragnarok officially begins when one of the Gods, Baldr, dies by being impaled with a spear covered in mistletoe. In order to stop this from happening, you must convince the mistletoe not to harm Baldr."

>l
Portal Room
A mostly empty room. The walls are all a bland grey and there are no windows. There is a bookshelf leaning against one of the walls. 

 To the south is the Underworld, Midgard it to the west, and there is a large gate to the north.

 
You can also see a large gate, a statue and Heimdallr here.

>x statue
A large stone statue of a tall bearded man holding a staff. It looks like part of the statue is starting to fall off. You can just make out hairline cracks near the hand holding the staff.

>break statue
You reach up and break off the staff that the statue was holding.

>take staff
You are going to need to use more force than that.

* * *

>take book
Taken.

>read page 1
(in the old book)
You read: " About the Ragnarok. "

>next page
That's not a verb I recognise.

>read next page
(in the old book)
You read: " About the Underworld. "

>read page 4
(in the old book)

>read page 3
(in the old book)
You read: " About Midgard. "

>read next page
(in the old book)

* * *

>take book
Taken.

>read page 3
(in the old book)
You read: " About Midgard. "

* * *

>take statue
That is way too large to carry.

>break statue
Violence isn't the answer to this one.